 5 30
 |------------------|
 |G.P|..-....-..|.G.|
 |..-|.@......P.....|
 |.G....-..|....-...|
 |------------------|